-----------------------------------------------------------------------------------------------------------------------------------------------------------------------
--•-------•-------•-------•-------•-------•-------•-------•-------•-------•-------•-------•-------•-------•-------•-------•-------•-------•-------•-------•-------•----
-•-•-----•-•-----•-•-----•-•-----•-•-----•-•-----•-•-----•-•-----•-•-----•-•-----•-•-----•-•-----•-•-----•-•-----•-•-----•-•-----•-•-----•-•-----•-•-----•-•-----•-•---
•---•---•---•---•---•---•---•---•---•---•---•---•---•---•---•---•---•---•---•---•---•---•---•---•---•---•---•---•---•---•---•---•---•---•---•---•---•---•---•---•---•--
-----•-•-----•-•-----•-•-----•-•-----•-•-----•-•-----•-•-----•-•-----•-•-----•-•-----•-•-----•-•-----•-•-----•-•-----•-•-----•-•-----•-•-----•-•-----•-•-----•-•-----•-
------•-------•-------•-------•-------•-------•-------•-------•-------•-------•-------•-------•-------•-------•-------•-------•-------•-------•-------•-------•-------•
-----------------------------------------------------------------------------------------------------------------------------------------------------------------------

