-----------------------------------------------------------------------------------------------------------------------------------------------------------------------
------•-------•-------•-------•-------•-------•-------•-------•-------•-------•-------•-------•-------•-------•-------•-------•-------•-------•-------•-------•-------•
-----•-•-----•-•-----•-•-----•-•-----•-•-----•-•-----•-•-----•-•-----•-•-----•-•-----•-•-----•-•-----•-•-----•-•-----•-•-----•-•-----•-•-----•-•-----•-•-----•-•-----•-
•---•---•---•---•---•---•---•---•---•---•---•---•---•---•---•---•---•---•---•---•---•---•---•---•---•---•---•---•---•---•---•---•---•---•---•---•---•---•---•---•---•--
-•-•-----•-•-----•-•-----•-•-----•-•-----•-•-----•-•-----•-•-----•-•-----•-•-----•-•-----•-•-----•-•-----•-•-----•-•-----•-•-----•-•-----•-•-----•-•-----•-•-----•-•---
--•-------•-------•-------•-------•-------•-------•-------•-------•-------•-------•-------•-------•-------•-------•-------•-------•-------•-------•-------•-------•----
-----------------------------------------------------------------------------------------------------------------------------------------------------------------------