-----------------------------------------------------------------------------------------------------------------------------------------------------------------------
----•-------•-------•-------•-------•-------•-------•-------•-------•-------•-------•-------•-------•-------•-------•-------•-------•-------•-------•-------•-------•--
---•-•-----•-•-----•-•-----•-•-----•-•-----•-•-----•-•-----•-•-----•-•-----•-•-----•-•-----•-•-----•-•-----•-•-----•-•-----•-•-----•-•-----•-•-----•-•-----•-•-----•-•-
--•---•---•---•---•---•---•---•---•---•---•---•---•---•---•---•---•---•---•---•---•---•---•---•---•---•---•---•---•---•---•---•---•---•---•---•---•---•---•---•---•---•
-•-----•-•-----•-•-----•-•-----•-•-----•-•-----•-•-----•-•-----•-•-----•-•-----•-•-----•-•-----•-•-----•-•-----•-•-----•-•-----•-•-----•-•-----•-•-----•-•-----•-•-----
•-------•-------•-------•-------•-------•-------•-------•-------•-------•-------•-------•-------•-------•-------•-------•-------•-------•-------•-------•-------•------
-----------------------------------------------------------------------------------------------------------------------------------------------------------------------