-----------------------------------------------------------------------------------------------------------------------------------------------------------------------
•-------•-------•-------•-------•-------•-------•-------•-------•-------•-------•-------•-------•-------•-------•-------•-------•-------•-------•-------•-------•------
-•-----•-•-----•-•-----•-•-----•-•-----•-•-----•-•-----•-•-----•-•-----•-•-----•-•-----•-•-----•-•-----•-•-----•-•-----•-•-----•-•-----•-•-----•-•-----•-•-----•-•-----
--•---•---•---•---•---•---•---•---•---•---•---•---•---•---•---•---•---•---•---•---•---•---•---•---•---•---•---•---•---•---•---•---•---•---•---•---•---•---•---•---•---•
---•-•-----•-•-----•-•-----•-•-----•-•-----•-•-----•-•-----•-•-----•-•-----•-•-----•-•-----•-•-----•-•-----•-•-----•-•-----•-•-----•-•-----•-•-----•-•-----•-•-----•-•-
----•-------•-------•-------•-------•-------•-------•-------•-------•-------•-------•-------•-------•-------•-------•-------•-------•-------•-------•-------•-------•--
-----------------------------------------------------------------------------------------------------------------------------------------------------------------------